aaaaaaaaaaaaaaaaaaaaaaaaaaaaaaaaaaaaaaaa
a``````````````````````````````````````a
a``````````````````````````````````````a
a``````````````````````````````````````a
a``````````````````````````````````````a
a``````````````````````````````````````a
a``````````````````````````````````````a
a``````````````````````````````````````a
a``````````````````````````````````````a
a``````````````````````````````````````a
a``````````````````````````````````````a
a``````````````````````````````````````a
a``````````````````````````````````````a
a``````````````````````````````````````a
a``````````````````````````````````````a
a``````````````````````````````````````a
a``````````````````````````````````````a
a``````````````````````````````````````a
a``````````````````````````````````````a
a``````````````````````````````````````a
a``````````````````````````````````````a
a``````````````````````````````````````a
a``````````````````````````````````````a
a``````````````````````````````````````a
a``````````````````````````````````````a
a````j`````````````````````````````````a
a`````````k````````````````````````````a
a`````````````i````````````d```e```````a
a``````````````````````````````````````a
a``````````````````````````````````````a
aaaaaaaaaaaaaaaaaaaaaaaaaaaaaaaaaaaaaaaa

